5555555555555555555555555555
5000000000000000000000000005
5000000000000000000000000005
5000000111111441111110000005
5000000111111441111110000005
5000000110011441100110000005
5000000110011441100110000005
5000000111111441100110000005
5000000111111441100110000005
5000000000011441100110000005
5000000000011441100110000005
5000000111111441111110000005
5000000111111441111110000005
5000000000000000000000000005
5000000000000000000000000005
5550000000000550000000000555
5550000000011551100000000555
5220000000011111100000000225
5221100110011111100110011225
5221155115511111155115511225
5221155115511111155115511225
5221100110011001100110011225
5221100110000000000110011225
5221100110000000000110011225
5221100110001111000110011225
5222222000001901000002222225
5222222000001001000002222225
5555555555555555555555555555
