6666666666666666666666666666
6000000000000000000000000006
6000000000000000000000000006
6001100110011001100110011006
6001100110011001100110011006
6001100110011001100110011006
6001100110011001100110011006
6001100110022110011001100006
6001100110022110011001100006
6001100110011001100110011006
6001100110000000011001100006
6001100110000000011001100006
6000000000011001100000000006
6000000000011001100000000006
6110011000000000000110011006
6220011000000000000110022006
6000000000011001100000000006
6000000000066000000000000006
6001100110066666600110011006
6001100110011001100110011006
6001100110011001100110011006
6001100110011001100110011006
6001100110000000011001100006
6001100110000000011001100006
6001100110001111001100110006
6000000000001901000000000006
6000000000001001000000000006
6666666666666666666666666666
