6666666666666666666666666666
6000055000000000000005500006
6000055000000000000005500006
6000055110000220000115500006
6000055110000220000115500006
6000044444444444444444400006
6000044444444444444444400006
6550000000000000000000000556
6550000000000000000000000556
6550000000000000000000000556
6000011110000000000111100006
6000011110000000000111100006
6111111112222222222111111116
6111111112222222222111111116
6000033333333333333333300006
6000033333333333333333300006
6333333331111111111333333336
6333333331111111111333333336
6555555553333333333555555556
6000000003333333333000000006
6000011000000000000001100006
6000011000000000000001100006
6000055552222222222555500006
6444444444444444444444444446
6444444444441111444444444446
6000000000001901000000000006
6000000000001001000000000006
6666666666666666666666666666
