6666666666666666666666666666
6000000000000000000000220006
6000000000000000000000220006
6000000000000000000022000006
6000000000220000000022000006
6000000011000001111000000006
6000001111110011111000000006
6000111111110011111000000006
6000111111112221111000000006
6001111441112221111000000006
6001111441114422111100000006
6022111144444422111100000006
6022111144444444222211000006
6011111144444444222211001106
6011111144444444442211001106
6221111444444444444411222206
6111144444444444444444111106
6111144444444444444444111106
6000114444444444444444110006
6000114444444444444444110006
6000114444444444444444110006
6000114444444444444444110006
6000114444000000000044110006
6000114444000000000044110006
6000114444001111000044110006
6000114400001901000044110006
6000114400001001000044110006
6666666666666666666666666666
