6666666666666666666666666666
6333333333333333333333333336
6333333333333333333333333336
6333333333333333333333333336
6333333333333333333333333336
6333333333333333333333333336
6333333333333333333333333336
6333333333333333333333333336
6333333333333333333333333336
6333333333333333333333333336
6333333333333333333333333336
6333333333333333333333333336
6333333333333333333333333336
6000000000000000000000000006
6000000000000000000000000006
6000000000000000000000000006
6000000000000000000000000006
6000000000000000000000000006
6000000000000000000000000006
6000000000000000000000000006
6000000000000000000000000006
6000000000000000000000000006
6000000000000000000000000006
6000000000000000000000000006
6000000000000000000000000006
6000000000000000000000000006
6000000000000000000000000006
6666666666666666666666666666
