6666666666666666666666666666
6000111111100000000000000006
6000111111100000000000000006
6000551111100115511000000116
6000115511100115511000000116
6000111111100000001100000116
6000000000000000001100000116
6000000000000000001100000116
6110000011551155550000055116
6110000011551111550000055116
6110000011111111550000000116
6110000011111155550000000116
6110000011111155550000000116
6000000011100000000000000116
6000000011100000000000000116
6000000011100000000000000556
6000000011100000001111000556
6000000055111550001111000006
6000000055111550004444000006
6000000000011000000000000006
6550000000011000000000000006
6550000000055115500000000446
6550000000055115500000000446
6440000005500000000000044446
6440000005501111000000044446
6444400000001901000000044446
6444400000001001000000044446
6666666666666666666666666666