6666666666666666666666666666
6000000000000000000000000006
6000122233330000223440000006
6000111110000000001111000006
6005500000044444400000055006
6111111144111441114411111166
6444444444444444444444444446
6000004444444444444440000006
6444411444444444444114444446
6444444444444444444444444446
6444411111444444111111444446
6444444444444444444444444446
6444444444444444444444444446
6220000222222222222220000226
6000000000000000000000000006
6550000000000550000000000556
6550000000044554400000000556
6220000000044444400000000226
6221100110044444400110011226
6221155115544444455115511226
6444444444444444444444444446
6444444444444444444444444446
6224444440000000000444444446
6005511110000000000111111006
6000000000001111000000000006
6000000000001901000000000006
6000000000001001000000000006
6666666666666666666666666666
