6666666666666666666666666666
6000044440000000000444400006
6000044440000000000444400006
6001144440011001100444411006
6001144440011001100444411006
6005533333333223333333355006
6005533333333223333333355006
6005533333333223333333355006
6005533333333223333333355006
6222200000000000000000022226
6222200000000000000000022226
6110011001100110011001100116
6110011001100110011001100116
6001100110011001100110011006
6001100110011001100110011006
6110011001100110011001100116
6110011001100110011001100116
6001100110011001100110011006
6001100110011001100110011006
6000000000005555000000000006
6000000000005555000000000006
6333333333331111333333333336
6333333333331111333333333336
6333333333331111333333333336
6333333333331111333333333336
6333333333331901333333333336
6333333333331001333333333336
6666666666666666666666666666

