6666666666666666666666666666
6000000000000000000000000006
6000000000000000000000000006
6000000111111441111110000006
6000000111111441111110000006
6000000110011441100110000006
6000000110011441100110000006
6000000111111441100110000006
6000000111111441100110000006
6000000000011441100110000006
6000000000011441100110000006
6000000111111441111110000006
6000000111111441111110000006
6000000000000000000000000006
6000000000000000000000000006
6000000000000550000000000006
6000000000011551100000000006
6440000000011111100000000446
6441100110011111100110011446
6441155115511111155115511446
6441155115511111155115511446
6441100110011001100110011446
6441100110000000000110011446
6441100110000000000110011446
6441100110001111000110011446
6444444000001901000004444446
6444444000001001000004444446
6666666666666666666666666666
