6666666666666666666666666666
6000000000000000000000000006
6000000000000000000000000006
6000000111111441111110000006
6000000111111441111110000006
6000000110011441100110000006
6000000110011441100110000006
6000000111111441100110000006
6000000111111441100110000006
6000000000011441100110000006
6000000000011441100110000006
6000000111111441111110000006
6000000111111441111110000006
6000000000000000000000000006
6000000000000000000000000006
6550000000000550000000000556
6550000000011551100000000556
6220000000011111100000000226
6221100110011111100110011226
6221155115511111155115511226
6221155115511111155115511226
6221100110011001100110011226
6221100110000000000110011226
6221100110000000000110011226
6221100110001111000110011226
6222222000001901000002222226
6222222000001001000002222226
6666666666666666666666666666
