6666666666666666666666666666
6444400000000000000000000006
6444403330000000000003333336
6442222220000000000003330006
6440000000000000220000000006
6440000033300000220004440006
6443330000000000220004440006
6440003000000000220000000006
6440000222200000220000000006
6440000000200000000444422226
6440000400200000000444422226
6000000004000004444444444446
6000222222222224444444444446
6002222222222222444444444446
6002200000000022000033333336
6002200000000022333333330006
6333333333333333333333300006
6333333000403333333333300006
6002222224444444444444400006
6000222224444444444444444446
6000022220000022222222200006
6444442220000022222222200006
6444440220000000044000004006
6222444420000000004000000006
6223333344441111000044444446
6424444444441901000000000006
6442444444441001000004000006
6666666666666666666666666666
