6666666666666666666666666666
6444444440000000000444444446
6444444440000000000444444446
6440000000044444400000000446
6440000000044444400000000446
6440000000000000000000000446
6440000555500000055550000446
6443333333300000033333333446
6443333333300000033333333446
6000000004433333344000000006
6000000004433333344000000006
6000000004433333344000000006
6000000114433333344110000006
6555551144444444444411555556
6555551144444444444411555556
6000000113333333333110000006
6000000003333333333000000006
6000000003311111133000000006
6001100003311111133000011006
6001111003311221133001111006
6000011113311001133111100006
6000000113311001133110000006
6400000113333333333110000046
6440000113333333333110000446
6444000000001111000000004446
6444400000001901000000044446
6444440000001001000000444446
6666666666666666666666666666
