6666666666666666666666666666
6000000000500000000000000006
6000000000500000000000000006
6005005500500005500550055006
6005005500500005500550055006
6000000000000000000000000006
6000000000000000000000000006
6005500055000550055005500006
6005500055000550055005500006
6000000055000050000000000006
6000000055000050000000000006
6000555555000000000555555556
6000555555000000000000000006
6000000000000000000000000006
6000000000000055555000000006
6000000055000055555000000006
6000000055000000000000000006
6000000055000000000000000006
6000000000000000000000000006
6000550000000000055555550006
6000000000000000000000000006
6000000000005500000000550006
6000000000000000000000550006
6000000000000000000000550006
6000000000001111000000550006
6000005000001901000000000006
6000005000001001000000000006
6666666666666666666666666666
