6666666666666666666666666666
6000000000000000000000000006
6000000000000000000000000006
6000111111111111111111110006
6000000000000000000000000006
6000000000000000000000000006
6000111111111111111111110006
6000000000000000000000000006
6000000000000000000000000006
6000000000000000000000000006
6000000000000000000000000006
6000000000000000000000000006
6000000000000000000000000006
6000000000000000000000000006
6000000000000000000000000006
6000000000000000000000000006
6000055000550005500055000006
6000055000550005500055000006
6000000000000000000000000006
6000000000000000000000000006
6000111111111111111111110006
6000444444444444444444440006
6000000000000000000000000006
6000000000000000000000000006
6000000000001111000000000006
6000000000001901000000000006
6000000000001001000000000006
6666666666666666666666666666