6666666666666666666666666666
6000000000000000000000000006
6001111100000000000111110006
6001001100000000001100110006
6111000011005555110000001106
6100000011005555110000000106
6550000011555555551100000056
6550000011555555551100000056
6550001111552222551110000556
6550001111552222551110000556
6100001104444444441100000106
6111111044444444441111111106
6111111122221122221111111106
6111111122221122221111111106
6000111000220011220001110006
6000111000220011220001110006
6000111111111111111111110006
6000111111111111111111110006
6555511111222211111111555566
6555100001222211110000155566
6000000000000000000000000066
6000000000000000000000000066
6000555550000000555550000006
6000000000000000000000000006
6000555550001111005555500006
6000100010001901001000100006
6000100010001001001000100006
6666666666666666666666666666
