6666666666666666666666666666
6000000000000000222222550006
6000000000000000222222550006
6011000000000000220000220006
6011000000000000220000220006
6055115500001111111100220006
6055115500001111111100220006
6000115550001100551102222206
6000115550001100551102222206
6000001100552211001100000006
6000001100552211001100000006
6000000022001100221111000006
6000000022001100221111000006
6000111122001100220000000006
6000111122001100220000000006
6022222550011000001111000006
6022222550011000001111000006
6022001111110000110222222206
6022001111110000110222222206
6022000022000000000022111106
6022000022000000000022111106
6055222222000000000000222226
6000000000010001000000222226
6000000000010001000000222226
6055222222001111000000222226
6000000000001901000000222226
6000000000001001000000222226
6666666666666666666666666666

