6666666666666666666666666666
6000000050000000000000000006
6000000050000000000000000006
6000000050000000000000000006
6444444444444444444440000006
6444444444444444444440000006
6000000000000555544444400006
6000000000000005544444400006
6000000000000000000444444446
6000000000000000000444444226
6000000000000000000444444226
6222200000011111111111100446
6222200000111111111111100446
6000044441111100000001100446
6000044441111000000001100446
6000044441100000044445500006
6000044441000000044445500006
6444444440022222244445500006
6444444440022222244445500006
6000000550055555500003333336
6000000550000000000003333336
6111111551111111444444000006
6111111551111111444444000006
6222222000000000000005500006
6222222000001111000005500006
6000000000001901000005500006
6000000000001001000005500006
6666666666666666666666666666
