6666666666666666666666666666
6000000440000000000400000006
6000000440000000000400010006
6000010000010001100000010006
6000010000010001100000010006
6000000000044444400000000006
6000000000000000000000000006
6001111111111111122220000006
6001111111115511122220000006
6000000100005500000000055006
6000000000005500000000000006
6000001100000000000000000006
6000001100000000000115500006
6000000000000000000115500006
6000000444444000000000000006
6000000444444000001111000006
6000011442244000001111000006
6000011442244000000000000006
6000011444444002200444440006
6000011444444002200444440006
6000011000000000000000110006
6000000000552200011000110006
6000011105522000011101100006
6000011100000000000055110006
6000000000001111000011000006
6444400000001900000001100006
6444400000001000000001111116
6666666666666666666666666666
